#######
# ##  #
# P   #
#     #
##X  ##
#     #
#   O #
#    ##
#######
