############
#        O #
# P     ####
#          #
#######    #
#O  ##     #
#   ##     #
#          #
#       XX #
#      #   #
############